12 49
####################### B #######################
######################$   $######################
#######################   #######################
#######################   #######################
#######################   #######################
#######################   #######################
#$                 $         $                 $#
#                                               #
#                                               #
#   #########################################   #
#   #########################################   #
# I ######################################### I #
