9 49
#################################################
#                        #$                     I
#         #$             #           ###        #
#$        #              #     #      $#        #
B         #                    #       #        I
#$        #$                   #                #
#                              #                #
#                  $          $#                I
#################################################
